444444444444
133333333334
444444444434
433333333334
434444444444
433333333334
444444444434
233333333334
444444444444