444444444444
433343334333
434343434343
134343434343
444333433343
444444444443
233433343333
443434343444
443334333444